11111111111111111111111111111
10000E000000000C00000C0000001
1P100101001000001010010000001
11100100101010100010010000001
100000000C00C0000000000000001
100000000000000C00000C0000001
10100101001000001010010000001
10100100101010100010010000001
100000000C00C0000000000000001
100000000000000C00000C0000001
11111111111111111111111111111
