11111111111111111111111111111
100000000E0000000000000000001
10000000000000000000000000001
10000000000000000000000000001
10000000000000000000000000001
10000000000011000000000000001
10000000000011000000000000001
10000000000000000000000000001
1P000000000000000000000000001
10000000000000000000000000001
10000000000000000000000000001
10000000000000000000000000001
1C000000000000000000000000001
10000000000000000000000000001
11111111111111111111111111111
