11111111111111111111111111111
1P000000000000000000000000001
10000000000000010000000000001
10101000000000000000000000001
101000000E0000000010000000001
10100000000111000000000000001
10100000000111000000000000001
10100000000111000000000000001
10100000000111000000000000001
10100000000111000000000000001
10100010001000000000000000001
10011111010000000000010000001
1C000000110000000000000000001
10001000000000000000010000001
11111111111111111111111111111
