11111111111111111111111111111
1P000100000000C00100000000001
10000000110010010010100101101
10011001001010100001001101001
100001000E1000000100000101001
10010010000101000101001001001
100010001001010001000001000C1
11000100100101000111100010001
10100011100101000000010010001
10110000000101000000001001011
10000010001000011110001010011
10011111010011000010010010011
1C000000100010001001100100001
1000101000100011000000C001001
11111111111111111111111111111
