11111111111111111111111111111
1P0000000E0000000000000000001
10000000000000000000000000001
10100000000000000000000000001
10100000000000000000000000001
10100000000011000000000000001
10100000000111000000000000001
10100000001000000000000000001
10100000001000000000000000001
10100000001000000000000000001
10100010001000000000000000001
10011111010000000000000000001
1C000000110000000000000000001
10000010000000000000000000001
11111111111111111111111111111
