11111111111111111111111111111
100010000E00000C00000C0000001
10101101001000001010010100101
11100100101010100010010100101
100000000C00C00000000000000C1
100000000000000C00000C0000001
10100101001000001010010100101
10100100101010100010010100101
1P0000000C00C00000000000000C1
100000000000000C00000C0000001
10100101001000001010010100101
10100100101010100010010101001
100000000C00C00000000000000C1
100000000C00C00000000000000C1
11111111111111111111111111111
