11111111111
1000E001001
1000C001P01
11111111111
