11111111111111111111111111111
10P00100C00000C0010C000000001
10000000110010010010100101101
10110001E01010100001001101001
100001000010000C0100000101001
10010010000101000101001001001
10001000100101000100000100001
11000100100101000111100010001
10100011100101000000010010001
10110000000101000000001001011
1C000010001000011110001010011
10011111010011000010010010011
100000001C00100010011C0100001
10001010001000110000000001001
11111111111111111111111111111
